X-----------------X--------------X
X-----X-----------X--------------X
X-P--XXX-------------------------X
X---XXXXX--M---S--X--S-----XXX---X
XXXXXXXXXXXXX--XX-X-XX--XXXXXXXXXX