X--------------------------
X--------------------------
X-P--XXX-------------------
X---XXXXX-----------------X
XXXXXXXXXXXXX--XX--XX--XXXX